    ####
#####  #
#   @  #
#  o#  #
## ## ##
#      #
# A #  #
#  #####
####